1111111111111111111111111111111
1P00001A0000000C0000000000A1001
1001001001001111001001111111001
1001000001000001001001000001001
1111111001111111111001001001001
1000001001000000001001001001001
1111001001111111001111111001001
10000000000A10010000000000000A1
1111001111001001111111111001001
10000010000000000A10010000A1001
1001111111111001001001111001111
1001000000000001001000001000001
1111001111001111001001111001111
1001001000001000001001001001001
1001111001111111001001001001001
1000000000001000000001000000001
1001111001111001111111111111001
10010010010010010C1C00000001001
1001001001C01111001111111001001
1000001C000000000000000000000E1
1111111111111111111111111111111